ALLC: ['Wi_U', 'WiD_Y', 'WiA_Y', 'WiA_Z', 'WiA_AB', 'WiB_AA'] 
BLYD: ['BV_H', 'BV_Q'] 
BONM: ['LA_D'] 
BROT: ['NE_A', 'NE_H', 'NE_L', 'NE_V', 'NE_Y', 'NE_AC', 'PE_E', 'PE_H', 'PE_I', 'PE_O', 'PE_P', 'PE_R'] 
CALV: ['Wi_C', 'Wi_G', 'Wi_N', 'Wi_Q', 'Wi_X', 'WiA_AA', 'WiB_AC'] 
CATP: ['PE_J', 'PE_AC'] 
COUM: ['DR_F', 'DR_J', 'DR_N'] 
DIJK: ['MM_K', 'MM_T', 'AK_V', 'AK_W', 'AK_Z'] 
ERPM: [] 
FARI: [] 
GEES: ['LA_C', 'LA_H', 'LA_AD'] 
GEMM: ['W&T_J', 'W&T_N', 'BIO_V', 'BIO_Y', 'ANW_Y'] 
GOCA: [] 
GODL: ['PE_C', 'PE_D', 'PE_F', 'PE_Q', 'PE_V', 'PE_W', 'PE_AA', 'PE_AF'] 
GREB: ['NE_J', 'NE_M', 'DR_C', 'DR_E', 'DR_O', 'DR_P', 'DR_Q', 'DR_R', 'DR_S', 'DR_T', 'DR_U'] 
HADS: ['AR_F', 'AR_M', 'AR_O', 'AR_Y', 'AR_AB'] 
HEEJ: ['W&T_M', 'W&T_R', 'BIO_X', 'BIO_AA', 'BIO_AE', 'BIO_AG'] 
HESA: ['MM_I', 'MM_O'] 
HOOJ: [] 
HUIA: ['MM_P', 'MM_AE', 'MM_AF', 'GS_V', 'GS_AE', 'GS_AF'] 
HUNJ: ['AK_Y', 'AK_AA', 'AK_AD', 'GS_W', 'GS_Y', 'GS_AC'] 
ISSA: ['EN_A', 'EN_H', 'EN_K', 'EN_Q', 'EN_S', 'EN_U', 'EN_W', 'EN_X', 'EN_AA'] 
JIMS: ['SP_O', 'SP_P', 'SP_Q', 'SP_R', 'SP_S', 'SP_T', 'SP_AB', 'SP_AC'] 
JOMA: ['GR_A', 'GR_B', 'GR_H', 'GR_I', 'LA_AE'] 
KAME: ['Wi_E', 'Wi_H', 'Wi_R', 'Wi_S', 'Wi_T', 'Wi_V', 'WiD_M'] 
KANS: ['W&T_I', 'W&T_L', 'W&T_T', 'W&T_U', 'BIO_W', 'BIO_AD', 'ANW_V', 'ANW_W', 'ANW_X', 'ANW_AA'] 
KOOM: ['BV_B', 'BV_I', 'BV_M', 'BV_N', 'BV_P', 'BV_S', 'BV_Y', 'BV_AC', 'BV_AD'] 
KRAA: ['MM_M', 'MM_N', 'MM_S', 'MM_AC'] 
KRME: [] 
LAAV: ['DR_D', 'DR_G', 'DR_H', 'DR_I', 'DR_K', 'DR_L', 'DR_M'] 
LIND: ['MM_Q', 'MM_R'] 
LUNS: [] 
MESJ: ['W&T_K', 'NK_AA', 'NK_AD'] 
MEYO: ['MU_C', 'MU_I', 'MU_N', 'MU_O', 'MU_P', 'MU_Q', 'MU_S', 'MU_T', 'MU_U', 'MU_V'] 
MIDR: ['W&T_O', 'W&T_P', 'SK_Y'] 
MOUJ: [] 
MUNR: ['EN_E', 'EN_I', 'EN_N', 'PE_X', 'PE_AB'] 
NAMJ: ['EN_C', 'EN_J', 'EN_L', 'EN_V'] 
NUIM: ['NE_C', 'NE_AB', 'NE_AD'] 
OUML: ['Wi_J', 'Wi_L', 'Wi_W', 'Wi_AE', 'WiD_R', 'WiB_Y'] 
PAPC: ['Wi_M', 'WiD_AA'] 
PARR: ['BV_A', 'BV_E', 'BV_F', 'BV_G', 'BV_O', 'BV_R', 'BV_T', 'BV_V', 'BV_AA', 'BV_AB'] 
POAN: ['GR_D', 'LA_E', 'LA_G'] 
POOA: ['EN_F', 'EN_AG'] 
POPC: ['Wi_D', 'Wi_F', 'Wi_I', 'Wi_P', 'WiD_O'] 
POSA: ['NE_B', 'NE_D', 'NE_F', 'NE_I', 'NE_Q', 'NE_U'] 
ROCI: ['MU_D', 'MU_E', 'MU_F', 'MU_G', 'MU_J', 'MU_K', 'MU_L', 'MU_M', 'MU_R'] 
SAKI: ['Wi_K', 'Wi_O', 'Wi_AF', 'WiD_V', 'WiA_AC'] 
SCHM: ['PE_G', 'PE_K', 'PE_L', 'PE_M', 'PE_N', 'PE_S', 'PE_T', 'PE_U'] 
SHAJ: ['EN_O', 'EN_R', 'EN_AB', 'EN_AE'] 
SIBE: ['NE_K', 'NE_S', 'NE_AE', 'NE_AF', 'GR_J'] 
SIEL: ['EN_D', 'EN_G', 'EN_P', 'EN_T', 'EN_Y', 'EN_AF'] 
SMAJ: ['W&T_Q', 'W&T_S'] 
SMIT: ['EN_M', 'EN_AC'] 
SNEL: ['NE_P', 'NE_Z', 'NE_AA'] 
STOT: ['NK_V', 'NK_W', 'NK_Y', 'NK_AF'] 
TENS: ['GR_F', 'GR_G', 'LA_A', 'LA_K'] 
VEEE: ['SK_V', 'SK_W', 'SK_Z', 'SK_AA', 'SK_AD'] 
VERM: ['MM_F', 'MM_G', 'MM_J', 'MM_L', 'MM_U', 'MM_AB', 'GS_AA', 'GS_AB'] 
VINI: ['NE_E', 'NE_G', 'NE_O', 'NE_R', 'NE_T', 'NE_X', 'GR_C', 'LA_B', 'LA_F'] 
WALD: [] 
WETC: ['MM_E', 'MM_H'] 
WETI: ['MU_H', 'MU_W'] 
YAKI: ['EC_AD', 'EC_AE', 'EC_AF'] 
